| | | | | | | | | | | | | | | |
| _ | _ _ Z _ Z _ _ _ _ _ J _ |
| _ _ _ _ _ | _ _ _ _ _ _ _ _ |
| _ | _ _ _ | _ _ _ _ _ _ _ _ |
| _ _ _ _ _ | _ _ _ _ _ _ _ _ |
| _ _ | | _ | _ _ _ _ _ _ _ _ |
| _ _ _ _ _ _ _ _ _ _ _ _ _ _ |
| _ _ _ _ _ _ _ _ _ _ _ _ _ _ |
| F _ _ _ _ _ _ _ _ _ _ _ _ _ |
| | | | | | | | | | | | | | | |